111111111111111111111111
100000000000000000000001
100000000000000000000001
100000000000000000000001
100000011111111100000001
100000000000000100000001
100000011111010100000001
100000000000000100000001
100000000000000100000001
100000000000000100000001
100000000000000100000001
100000000000000100010001
100000000000000000010001
100000000000000000010001
100000001111111100010001
100000000000000000010001
100000000000000000010001
100000000000000000010001
100000001111111110010001
100000000000000000000001
100000000000000000000001
100000000000000000000001
111111111111111111111111